9 11
0 0
...........
..##.......
..##..###..
........#..
..####..#..
...........
..###......
......##...
...........
