10 12
0 0
............
............
..##....##..
..##....##..
......##..##
......##..##
..####......
..####......
........##..
........##..