50 50
0 0
..................................................
..................................................
..##..##..##..##..##..##..##..##..##..##..##..##..
..##..##..##..##..##..##..##..##..##..##..##..##..
..................................................
..................................................
..################################################
..################################################
..................................................
..................................................
..##..##..##..##..##..##..##..##..##..##..##..##..
..##..##..##..##..##..##..##..##..##..##..##..##..
..................................................
..................................................
..################################################
..################################################
..................................................
..................................................
..##..##..##..##..##..##..##..##..##..##..##..##..
..##..##..##..##..##..##..##..##..##..##..##..##..
..................................................
..................................................
..################################################
..################################################
..................................................
..................................................
..##..##..##..##..##..##..##..##..##..##..##..##..
..##..##..##..##..##..##..##..##..##..##..##..##..
..................................................
..................................................
..################################################
..################################################
..................................................
..................................................
..##..##..##..##..##..##..##..##..##..##..##..##..
..##..##..##..##..##..##..##..##..##..##..##..##..
..................................................
..................................................
..################################################
..################################################
..................................................
..................................................
..##..##..##..##..##..##..##..##..##..##..##..##..
..##..##..##..##..##..##..##..##..##..##..##..##..
..................................................
..................................................
..################################################
..################################################
..################################################
..################################################
