8 10
0 0
..........
######.###
..........
###.######
..........
######.###
..........
..........
